....MMMMM
....M...M
....MX..M
..MMM..XMM
..M..X.X.M
MMM.M.MM.M...MMMMMM
M...M.MM.MMMMM..OOM
M.X..X..........OOM
MMMMM.MMM.MKMM..OOM
....M.....MMMMMMMMM
....MMMMMMM