MMMMMMMMMMM
M.........M
M..M.M....M
M........MM
MMM...M..M
MMMOMMMM.M
M.KMM..M.M
MXX....M.M
M.XMM....M
M..MO....M
M..MMMM..M
M..MMMO..M
MMMMMMMMMM