MMMMMMMMMMMMMMMMMMMMMMMMMMMM
MM...........M............MM
MM...........M............MM
MMOMMMM.MMMM.M..........MOMM
MMMMMM.................MMMMM
MMM..M................M..MMM
MMM.XM..M.MMMMMMMMMM.MMX.MMM
MMM...MM.....K...........MMM
MMM.................MM...MMM
MMM.XMM.MMMMMMMMMM.M..MX.MMM
MMM..M................M..MMM
MMMMM..................MMMMM
MMOM.........M.MMMMM.MMMMOMM
MM...........M............MM
MM...........M............MM
MMMMMMMMMMMMMMMMMMMMMMMMMMMM