MMMMMMMMMMMMMMMMMMMM
M...M...M....M...MKM
M...X..X.....M.X.M.M
MMXM.XMMM.M....XXM.M
M..M..MOMMM..MX.X..M
M..MXMOOOOM..M.MMM.M
M.X..MOOOOOMM....M.M
MMX..MOMOOOOMXX.X..M
M..MMMMMMOOMM.M..M.M
M..X.........X.MMM.M
M...M...M........M.M
MMMMMMMMMMMMMMMMMMMM
