MMMMMMMMMMMMMMMMMMMM
M.M.M.M...MKMM...M.M
M.............X....M
M..MMXM.MMMMM.X.M.MM
MM....MMOOOOOM..M..M
MMXMMXMOOOOOMMMXMX.M
M...M.MMOOOOOM..M.MM
M..X....MMOOMM..M..M
M.X.M...X...X..XXX.M
MM.X..XM.M..M..X...M
M...MM...M..M......M
MMMMMMMMMMMMMMMMMMMM