MMMMMMMMMMMMMMMMMMMMMMMMMMMMMMM
MMMMMMMM......................M
M......MMM.MMMMMMMMM.MMMM.XM..M
M..MM..............X..X.M..M.KM
M..M.....M.......MMMMMM.M.XM..M
MMMM...MMM....................M
MM...MMM.....MMMMMMMMMMMMMMMMMM
MM....MM....MMMMMMM
MM....MM...MMMMMMM
MM..MMMMM.MMMMMMM
M....MM....MMMMM
M....MM.....MMM
MO..OMMO..OMMM
MMMMMMMMMMMMM