MMMMMMMMMMMMMMMMMMMM
MK.....M...M.......M
MM.MMM.MM..MMMM.M.MM
M....M.M..XX.......M
M..M.M.M.X.M.X.MM.MM
M.....X.M..MXX.M...M
M..MMM..M......MM.MM
MOOMOM.X.M..X.M....M
MOOMOM..X.M.MM.XX..M
MOOOOMM...XX..X..M.M
MOOOOOMM........M..M
MMMMMMMMMMMMMMMMMMMM
