.................MMMMMMMMMMM
.................M......M.KM
................MMM.MM.MMXMM
...............MMMM........M
MMMMM........MM...M.MM.MM..M
MMM..MMM.....MM........MM..M
MMM....M....MM......MMMMMMMM
MM..M..M...MM.M...MMM
MM..M.M...M...M...MM
MMM.M..MMMM.M....MM
M...M..........MMMM
M.....MMMMMMMMMMMM
MOMMMMM
MMMMMM