MMMMMMMMMMMMMMM
MK.....M......MMMM
M....X.MMMMM.....M
MMMMM......M.MM..M
M...M......MOMM...M
M...M...M..MMMM...M
M...M...M..M...M..MMMMMMMM
M.X.MMMMM..M.............M
M.X........MMMMM.........M
MMMMMMM........X.........M
......M....MMMMM..MMMMMMMM
......M.M..M......X......M
......M.MM.M......M......M
.....M....MM.....M.M.....M
.....M....MM....M.O.M....M
MMMMMM..M.MM.....M.M.....M
M.......M.MM.............M
M.MMMMMMM..MMM......MMMMMM
MOMMO......MO...MMMMMMMMMM
MMMMMMMMMMMMMMMMMMMMMMMMMM