MMMMMMMMMMMMMMMMMMMM
M.....M...MMMMM....M
MM.X..M...MMMM..X..M
MMMM.XX...MOOM..M..M
M..X..X..MMOOMMMM.MM
M.X...MMMOOOO...XX.M
M..MXM...OOOOM.M.X.M
M.M..M.X.OOMMMXM...M
M.M...X.MOOM...MM..M
M...XM..MMMM...M.XMM
M.M..M....KM......MM
MMMMMMMMMMMMMMMMMMMM
