MMMMMMMMMMMMMMMMMMMM
M........M...MK.M..M
M.XX..MXXM.M.M..MM.M
M..M.X.X.MXX.M.....M
MM.M..M..M.M.M..M..M
M...MM.......M.....M
M...M.X.M...M...M..M
M.X.MX.M...M..X.MOOM
MMX.M..MMMM....MOOOM
M..X..........MOOOOM
M...M..M.....MOOOOOM
MMMMMMMMMMMMMMMMMMMM
